NO ./textures/north.xpm
SO ./textures/south.xpm
WE ./textures/west.xpm
EA ./textures/east.xpm

F 100,100,100
C 200,200,255

1111111111111111111111111
1000000000000000000000001
1011110111110111110111101
1000000100000100000100001
1111011101110111011101111
1000010000000100000000001
1011010111111111111110101
1000010100000000000010001
1111110111011111101111101
1000000101000000100000101
1011101111111111111110101
100000000000E0000000000001
1111111111111111111111111
